MMMMMMMMMMMMMMM
E+++++M+++++++M
M+MMM+++MMMMM+M
M+M+++MMM+++++M
MMMMMMMM++MMMMM
M+++++++++++++M
M+MMMMMMMMMMM+M
M++++++MMMMMM+M
MMMMMM+MMMM+++M
M++++++MMM++MMM
M+MMMMMMMMMMMMM
M+++++++++++++M
MMMMM+MMMMMMMMM
M+++++++++++++G
MMMMMMMMMMMMMMM