MMMMMMMMMMMMMMM
++++++++M+++++M
MM+MMMM+M+MMM+M
M++MM+++M+M+M+M
M+MMMMMMM+M+M+M
M++MM+++++++M+M
M+++++MMMMMMM+M
M+MMMMM+M+++++M
M+M+++M+M+MMMMM
M+M+M+M+M+++++M
M+M+M+M+MMMMM+M
M+M+M+M+MMMMM+M
M+M+M+++MMMM++M
M+++M++++++M++G
MMMMMMMMMMMMMMM
